Wade	Claudia
Oliver	Rosa
Jake	Sandra
Noah	Eunice
James	Kayla
Dave	Kathryn
Seth	Rosie
Ivan	Monique
Riley	Maggie
Gilbert	Hope
Jorge	Alexia
Dan	Lucille
Brian	Odessa
Roberto	Amanda
Ramon	Kimberly
Miles	Blanche
Liam	Tyra
Nathaniel	Helena
Ethan	Kayleigh
Lewis	Lucia
Milton	Janine
Claude	Maribel
Joshua	Camille
Glen	Alisa
Harvey	Vivian
Blake	Lesley
Antonio	Rachelle
Connor	Kianna
Julian	Williams
Aidan	Harris
Harold	Thomas
Conner	Robinson
Peter	Walker
Hunter	Scott
Eli	Nelson
Alberto	Mitchell
Carlos	Morgan
Shane	Cooper
Aaron	Howard
Marlin	Davis
Paul	Miller
Ricardo	Martin
Hector	Smith
Alexis	Anderson
Adrian	White
Kingston	Perry
Douglas	Clark
Gerald	Richards
Joey	Wheeler
Johnny	Warburton
Charlie	Stanley
Scott	Holland
Martin	Terry
Tristin	Shelton
Troy	Miles
Tommy	Lucas
Rick	Fletcher
Victor	Parks
Jessie	Norris
Neil	Guzman
Ted	Daniel
Nick	Newton
Wiley	Potter
Morris	Francis
Clark	Erickson
Stuart	Norman
Orlando	Moody
Keith	Lindsey
Marion	Gross
Marshall	Sherman
Noel	Simon
Everett	Jones
Romeo	Brown
Sebastian	Garcia
Stefan	Rodriguez
Robin	Lee
Clarence	Young
Sandy	Hall
Ernest	Allen
Samuel	Lopez
Benjamin	Green
Luka	Gonzalez
Fred	Baker
Albert	Adams
Greyson	Perez
Terry	Campbell
Cedric	Shaw
Joe	Gordon
Paul	Burns
George	Warren
Bruce	Long
Christopher	Mcdonald
Mark	Gibson
Ron	Ellis
Craig	Fisher
Philip	Reynolds
Jimmy	Jordan
Arthur	Hamilton
Jaime	Ford
Perry	Graham
Harold	Griffin
Jerry	Russell
Shawn	Foster
Walter	Butler
Daisy	Simmons
Deborah	Flores
Isabel	Bennett
Stella	Sanders
Debra	Hughes
Beverly	Bryant
Vera	Patterson
Angela	Matthews
Lucy	Jenkins
Lauren	Watkins
Janet	Ward
Loretta	Murphy
Tracey	Bailey
Beatrice	Bell
Sabrina	Cox
Melody	Martinez
Chrysta	Evans
Christina	Rivera
Vicki	Peterson
Molly	Gomez
Alison	Murray
Miranda	Tucker
Stephanie	Hicks
Leona	Crawford
Katrina	Mason
Mila	Rice
Teresa	Black
Gabriela	Knight
Ashley	Arnold
Nicole	Wagner
Valentina	Mosby
Rose	Ramirez
Juliana	Coleman
Alice	Powell
Kathie	Singh
Gloria	Patel
Luna	Wood
Phoebe	Wright
Angelique	Stephens
Graciela	Eriksen
Gemma	Cook
Katelynn	Roberts
Danna	Holmes
Luisa	Kennedy
Julie	Saunders
Olive	Fisher
Carolina	Hunter
Harmony	Reid
Hanna	Stewart
Anabelle	Carter
Francesca	Phillips
Whitney	Spencer
Skyla	Howell
Nathalie	Alvarez
Sophie	Little
Hannah	Jacobs
Silvia	Foreman
Sophia	Knowles
Della	Meadows
Myra	Richmond
Blanca	Valentine
Bethany	Dudley
Robyn	Woodward
Traci	Weasley
Desiree	Livingston
Laverne	Sheppard
Patricia	Kimmel
Alberta	Noble
Lynda	Leach
Cara	Gentry
Brandi	Lara
Janessa	Pace
Claudia	Trujillo
Rosa	Grant
Sandra	Wade
Eunice	Oliver
Kayla	Jake
Kathryn	Noah
Rosie	James
Monique	Dave
Maggie	Seth
Hope	Ivan
Alexia	Riley
Lucille	Gilbert
Odessa	Jorge
Amanda	Dan
Kimberly	Brian
Blanche	Roberto
Tyra	Ramon
Helena	Miles
Kayleigh	Liam
Lucia	Nathaniel
Janine	Ethan
Maribel	Lewis
Camille	Milton
Alisa	Claude
Vivian	Joshua
Lesley	Glen
Rachelle	Harvey
Kianna	Blake
Williams	Antonio
Harris	Connor
Thomas	Julian
Robinson	Aidan
Walker	Harold
Scott	Conner
Nelson	Peter
Mitchell	Hunter
Morgan	Eli
Cooper	Alberto
Howard	Carlos
Davis	Shane
Miller	Aaron
Martin	Marlin
Smith	Paul
Anderson	Ricardo
White	Hector
Perry	Alexis
Clark	Adrian
Richards	Kingston
Wheeler	Douglas
Warburton	Gerald
Stanley	Joey
Holland	Johnny
Terry	Charlie
Shelton	Scott
Miles	Martin
Lucas	Tristin
Fletcher	Troy
Parks	Tommy
Norris	Rick
Guzman	Victor
Daniel	Jessie
Newton	Neil
Potter	Ted
Francis	Nick
Erickson	Wiley
Norman	Morris
Moody	Clark
Lindsey	Stuart
Gross	Orlando
Sherman	Keith
Simon	Marion
Jones	Marshall
Brown	Noel
Garcia	Everett
Rodriguez	Romeo
Lee	Sebastian
Young	Stefan
Hall	Robin
Allen	Clarence
Lopez	Sandy
Green	Ernest
Gonzalez	Samuel
Baker	Benjamin
Adams	Luka
Perez	Fred
Campbell	Albert
Shaw	Greyson
Gordon	Terry
Burns	Cedric
Warren	Joe
Long	Paul
Mcdonald	George
Gibson	Bruce
Ellis	Christopher
Fisher	Mark
Reynolds	Ron
Jordan	Craig
Hamilton	Philip
Ford	Jimmy
Graham	Arthur
Griffin	Jaime
Russell	Perry
Foster	Harold
Butler	Jerry
Simmons	Shawn
Flores	Walter
Bennett	Daisy
Sanders	Deborah
Hughes	Isabel
Bryant	Stella
Patterson	Debra
Matthews	Beverly
Jenkins	Vera
Watkins	Angela
Ward	Lucy
Murphy	Lauren
Bailey	Janet
Bell	Loretta
Cox	Tracey
Martinez	Beatrice
Evans	Sabrina
Rivera	Melody
Peterson	Chrysta
Gomez	Christina
Murray	Vicki
Tucker	Molly
Hicks	Alison
Crawford	Miranda
Mason	Stephanie
Rice	Leona
Black	Katrina
Knight	Mila
Arnold	Teresa
Wagner	Gabriela
Mosby	Ashley
Ramirez	Nicole
Coleman	Valentina
Powell	Rose
Singh	Juliana
Patel	Alice
Wood	Kathie
Wright	Gloria
Stephens	Luna
Eriksen	Phoebe
Cook	Angelique
Roberts	Graciela
Holmes	Gemma
Kennedy	Katelynn
Saunders	Danna
Fisher	Luisa
Hunter	Julie
Reid	Olive
Stewart	Carolina
Carter	Harmony
Phillips	Hanna
Spencer	Anabelle
Howell	Francesca
Alvarez	Whitney
Little	Skyla
Jacobs	Nathalie
Foreman	Sophie
Knowles	Hannah
Meadows	Silvia
Richmond	Sophia
Valentine	Della
Dudley	Myra
Woodward	Blanca
Weasley	Bethany
Livingston	Robyn
Sheppard	Traci
Kimmel	Desiree
Noble	Laverne
Leach	Patricia
Gentry	Alberta
Lara	Lynda
Pace	Cara
Trujillo	Brandi
Grant	Janessa
Rosamond Shawe 
Elinore Benyard