Aaron	Howard
Adams	Luka
Adrian	White
Aidan	Harris
Albert	Adams
Alberta	Noble
Alberto	Mitchell
Alexia	Riley
Alexis	Anderson
Alice	Powell
Alisa	Claude
Alison	Murray
Allen	Clarence
Alvarez	Whitney
Amanda	Dan
Anabelle	Carter
Anderson	Ricardo
Angela	Matthews
Angelique	Stephens
Antonio	Rachelle
Arnold	Teresa
Arthur	Hamilton
Ashley	Arnold
Bailey	Janet
Baker	Benjamin
Beatrice	Bell
Bell	Loretta
Benjamin	Green
Bennett	Daisy
Bethany	Dudley
Beverly	Bryant
Black	Katrina
Blake	Lesley
Blanca	Valentine
Blanche	Roberto
Brandi	Lara
Brian	Odessa
Brown	Noel
Bruce	Long
Bryant	Stella
Burns	Cedric
Butler	Jerry
Camille	Milton
Campbell	Albert
Cara	Gentry
Carlos	Morgan
Carolina	Hunter
Carter	Harmony
Cedric	Shaw
Charlie	Stanley
Christina	Rivera
Christopher	Mcdonald
Chrysta	Evans
Clarence	Young
Clark	Adrian
Clark	Erickson
Claude	Maribel
Claudia	Trujillo
Coleman	Valentina
Conner	Robinson
Connor	Kianna
Cook	Angelique
Cooper	Alberto
Cox	Tracey
Craig	Fisher
Crawford	Miranda
Daisy	Simmons
Dan	Lucille
Daniel	Jessie
Danna	Holmes
Dave	Kathryn
Davis	Shane
Deborah	Flores
Debra	Hughes
Della	Meadows
Desiree	Livingston
Douglas	Clark
Dudley	Myra
Eli	Nelson
Elinore Benyard
Ellis	Christopher
Erickson	Wiley
Eriksen	Phoebe
Ernest	Allen
Ethan	Kayleigh
Eunice	Oliver
Evans	Sabrina
Everett	Jones
Fisher	Luisa
Fisher	Mark
Fletcher	Troy
Flores	Walter
Ford	Jimmy
Foreman	Sophie
Foster	Harold
Francesca	Phillips
Francis	Nick
Fred	Baker
Gabriela	Knight
Garcia	Everett
Gemma	Cook
Gentry	Alberta
George	Warren
Gerald	Richards
Gibson	Bruce
Gilbert	Hope
Glen	Alisa
Gloria	Patel
Gomez	Christina
Gonzalez	Samuel
Gordon	Terry
Graciela	Eriksen
Graham	Arthur
Grant	Janessa
Green	Ernest
Greyson	Perez
Griffin	Jaime
Gross	Orlando
Guzman	Victor
Hall	Robin
Hamilton	Philip
Hanna	Stewart
Hannah	Jacobs
Harmony	Reid
Harold	Griffin
Harold	Thomas
Harris	Connor
Harvey	Vivian
Hector	Smith
Helena	Miles
Hicks	Alison
Holland	Johnny
Holmes	Gemma
Hope	Ivan
Howard	Carlos
Howell	Francesca
Hughes	Isabel
Hunter	Julie
Hunter	Scott
Isabel	Bennett
Ivan	Monique
Jacobs	Nathalie
Jaime	Ford
Jake	Sandra
James	Kayla
Janessa	Pace
Janet	Ward
Janine	Ethan
Jenkins	Vera
Jerry	Russell
Jessie	Norris
Jimmy	Jordan
Joe	Gordon
Joey	Wheeler
Johnny	Warburton
Jones	Marshall
Jordan	Craig
Jorge	Alexia
Joshua	Camille
Julian	Williams
Juliana	Coleman
Julie	Saunders
Katelynn	Roberts
Kathie	Singh
Kathryn	Noah
Katrina	Mason
Kayla	Jake
Kayleigh	Liam
Keith	Lindsey
Kennedy	Katelynn
Kianna	Blake
Kimberly	Brian
Kimmel	Desiree
Kingston	Perry
Knight	Mila
Knowles	Hannah
Lara	Lynda
Lauren	Watkins
Laverne	Sheppard
Leach	Patricia
Lee	Sebastian
Leona	Crawford
Lesley	Glen
Lewis	Lucia
Liam	Tyra
Lindsey	Stuart
Little	Skyla
Livingston	Robyn
Long	Paul
Lopez	Sandy
Loretta	Murphy
Lucas	Tristin
Lucia	Nathaniel
Lucille	Gilbert
Lucy	Jenkins
Luisa	Kennedy
Luka	Gonzalez
Luna	Wood
Lynda	Leach
Maggie	Seth
Maribel	Lewis
Marion	Gross
Mark	Gibson
Marlin	Davis
Marshall	Sherman
Martin	Marlin
Martin	Terry
Martinez	Beatrice
Mason	Stephanie
Matthews	Beverly
Mcdonald	George
Meadows	Silvia
Melody	Martinez
Mila	Rice
Miles	Blanche
Miles	Martin
Miller	Aaron
Milton	Janine
Miranda	Tucker
Mitchell	Hunter
Molly	Gomez
Monique	Dave
Moody	Clark
Morgan	Eli
Morris	Francis
Mosby	Ashley
Murphy	Lauren
Murray	Vicki
Myra	Richmond
Nathalie	Alvarez
Nathaniel	Helena
Neil	Guzman
Nelson	Peter
Newton	Neil
Nick	Newton
Nicole	Wagner
Noah	Eunice
Noble	Laverne
Noel	Simon
Norman	Morris
Norris	Rick
Odessa	Jorge
Olive	Fisher
Oliver	Rosa
Orlando	Moody
Pace	Cara
Parks	Tommy
Patel	Alice
Patricia	Kimmel
Patterson	Debra
Paul	Burns
Paul	Miller
Perez	Fred
Perry	Alexis
Perry	Graham
Peter	Walker
Peterson	Chrysta
Philip	Reynolds
Phillips	Hanna
Phoebe	Wright
Potter	Ted
Powell	Rose
Rachelle	Harvey
Ramirez	Nicole
Ramon	Kimberly
Reid	Olive
Reynolds	Ron
Ricardo	Martin
Rice	Leona
Richards	Kingston
Richmond	Sophia
Rick	Fletcher
Riley	Maggie
Rivera	Melody
Roberto	Amanda
Roberts	Graciela
Robin	Lee
Robinson	Aidan
Robyn	Woodward
Rodriguez	Romeo
Romeo	Brown
Ron	Ellis
Rosa	Grant
Rosamond Shawe
Rose	Ramirez
Rosie	James
Russell	Perry
Sabrina	Cox
Samuel	Lopez
Sanders	Deborah
Sandra	Wade
Sandy	Hall
Saunders	Danna
Scott	Conner
Scott	Holland
Sebastian	Garcia
Seth	Rosie
Shane	Cooper
Shaw	Greyson
Shawn	Foster
Shelton	Scott
Sheppard	Traci
Sherman	Keith
Silvia	Foreman
Simmons	Shawn
Simon	Marion
Singh	Juliana
Skyla	Howell
Smith	Paul
Sophia	Knowles
Sophie	Little
Spencer	Anabelle
Stanley	Joey
Stefan	Rodriguez
Stella	Sanders
Stephanie	Hicks
Stephens	Luna
Stewart	Carolina
Stuart	Norman
Ted	Daniel
Teresa	Black
Terry	Campbell
Terry	Charlie
Thomas	Julian
Tommy	Lucas
Tracey	Bailey
Traci	Weasley
Tristin	Shelton
Troy	Miles
Trujillo	Brandi
Tucker	Molly
Tyra	Ramon
Valentina	Mosby
Valentine	Della
Vera	Patterson
Vicki	Peterson
Victor	Parks
Vivian	Joshua
Wade	Claudia
Wagner	Gabriela
Walker	Harold
Walter	Butler
Warburton	Gerald
Ward	Lucy
Warren	Joe
Watkins	Angela
Weasley	Bethany
Wheeler	Douglas
White	Hector
Whitney	Spencer
Wiley	Potter
Williams	Antonio
Wood	Kathie
Woodward	Blanca
Wright	Gloria
Young	Stefan
